01 01 01 01 01 01 01 01 01 01 01 01 01 01 01 01 01 01 01 01 01 01 01 01 01 01 01 01
01 20 20 20 20 20 20 20 20 20 20 20 20 01 01 20 20 20 20 20 20 20 20 20 20 20 20 01
01 20 01 01 01 01 20 01 01 01 01 01 20 01 01 20 01 01 01 01 01 20 01 01 01 01 20 01
01 21 01 32 32 01 20 01 32 32 32 01 20 01 01 20 01 32 32 32 01 20 01 32 32 01 21 01
01 20 01 01 01 01 20 01 01 01 01 01 20 01 01 20 01 01 01 01 01 20 01 01 01 01 20 01
01 20 20 20 20 20 20 20 20 20 20 20 20 20 20 20 20 20 20 20 20 20 20 20 20 20 20 01
01 20 01 01 01 01 20 01 01 20 01 01 01 01 01 01 01 01 20 01 01 20 01 01 01 01 20 01
01 20 01 01 01 01 20 01 01 20 01 01 01 01 01 01 01 01 20 01 01 20 01 01 01 01 20 01
01 20 20 20 20 20 20 01 01 20 20 20 20 01 01 20 20 20 20 01 01 20 20 20 20 20 20 01
01 01 01 01 01 01 20 01 01 01 01 01 00 01 01 00 01 01 01 01 01 20 01 01 01 01 01 01
32 32 32 32 32 01 20 01 01 01 01 01 00 01 01 00 01 01 01 01 01 20 01 32 32 32 32 32
32 32 32 32 32 01 20 01 01 00 00 00 00 00 00 00 00 00 00 01 01 20 01 32 32 32 32 32
32 32 32 32 32 01 20 01 01 00 01 01 01 31 31 01 01 01 00 01 01 20 01 32 32 32 32 32
01 01 01 01 01 01 20 01 01 00 01 32 32 31 31 32 32 01 00 01 01 20 01 01 01 01 01 01
00 00 00 00 00 00 20 00 00 00 01 32 11 12 13 14 32 01 00 00 00 20 00 00 00 00 00 00
01 01 01 01 01 01 20 01 01 00 01 32 32 32 32 32 32 01 00 01 01 20 01 01 01 01 01 01
32 32 32 32 32 01 20 01 01 00 01 01 01 01 01 01 01 01 00 01 01 20 01 32 32 32 32 32
32 32 32 32 32 01 20 01 01 00 00 00 00 00 00 00 00 00 00 01 01 20 01 32 32 32 32 32
32 32 32 32 32 01 20 01 01 00 01 01 01 01 01 01 01 01 00 01 01 20 01 32 32 32 32 32
01 01 01 01 01 01 20 01 01 00 01 01 01 01 01 01 01 01 00 01 01 20 01 01 01 01 01 01
01 20 20 20 20 20 20 20 20 20 20 20 20 01 01 20 20 20 20 20 20 20 20 20 20 20 20 01
01 20 01 01 01 01 20 01 01 01 01 01 20 01 01 20 01 01 01 01 01 20 01 01 01 01 20 01
01 20 01 01 01 01 20 01 01 01 01 01 20 01 01 20 01 01 01 01 01 20 01 01 01 01 20 01
01 21 20 20 01 01 20 20 20 20 20 20 20 10 00 20 20 20 20 20 20 20 01 01 20 20 21 01
01 01 01 20 01 01 20 01 01 20 01 01 01 01 01 01 01 01 20 01 01 20 01 01 20 01 01 01
01 01 01 20 01 01 20 01 01 20 01 01 01 01 01 01 01 01 20 01 01 20 01 01 20 01 01 01
01 20 20 20 20 20 20 01 01 20 20 20 20 01 01 20 20 20 20 01 01 20 20 20 20 20 20 01
01 20 01 01 01 01 01 01 01 01 01 01 20 01 01 20 01 01 01 01 01 01 01 01 01 01 20 01
01 20 01 01 01 01 01 01 01 01 01 01 20 01 01 20 01 01 01 01 01 01 01 01 01 01 20 01
01 20 20 20 20 20 20 20 20 20 20 20 20 20 20 20 20 20 20 20 20 20 20 20 20 20 20 01
01 01 01 01 01 01 01 01 01 01 01 01 01 01 01 01 01 01 01 01 01 01 01 01 01 01 01 01